# # # # # # # . . . . . . . . . . . . . . . . . . . . . . . . . . . . . . . . . .
 # . . . . . # . . . . . . . . . . . . . . . . . . . . . . . . . . . . . . . . . .
 # . . . . . # . . . . . . . . . . . . . . . . . . . . . . . . . . . . . . . . . .
 # . . . . . # . . . . . . . . . . . . . . . . . . . . . . . . . . . . . . . . . .
 # . . . . . # . . . . . . . . . . . . . . . . . . . . . . . . . . . . . . . . . .
 # . . . . . # . . . . . . . . . . . . . . . . . . . . . . . . . . . . . . . . . .
 # . . . . . # . . . . . . . . . . . . . . . . . . . . . . . # # # # # . . . . . .
 # . . . . . # . . . . . . . . . . . . . . . . . . . . . . . # . . . # . . . . . .
 # . . . . . # . . . . . . . . . . . . . . . . . . . . . . . # . . . # . . . . . .
 # . . . . . # . . . . . . . . . . . . . . . . . . . . . . . # . . . # . . . . . .
 # # # # # # # # # # # . . . . . . . . . . . . . . . . . # # # # # # # # # # # . .
 . . . . . . # . . . # . . . . . . . . . . . . . . . . . # . # . . . # . . . # . .
 . . . . . . # # # # # # # . . . . . . . . . . . # # # # # # # . . . # . . . # . .
 . . . . . . . . . . # . # . . . . . . . . . . . # . . . # . . . . . # . . . # . .
 . . . . . . . . . . # . # . . . . . . . . . . . # . . . # . . . . . # . . . # . .
 . . . . . . . . . . # . # . . . . . . . . . . . # . . . # . . . . . # . . . # . .
 . . . . . . . . . . # # # # # # # . . . . . . . # . # # # # # # # # # # # # # . .
 . . . . . . . . . . . . # . . . # . . . . . . . # . # . # . . . . . # . . . . . .
 . . . . . . . . . . . . # # # # # # # # # # # # # . # . # . . . . . # # # # # # ^
 . . . . . . . . . . . . . . . . # . . . . . . . . . # . # . . . . . . . . . . . .
 . . . . . . . . . . . . . . . . # . . . . . # # # # # # # . . . . . . . . . . . .
 . . . . . . . . . . . . . . . . # . . . . . # . . . # . . . . . . . . . . . . . .
 . . . . . . . . . . . . . . . . # . . . # # # # # # # . . . . . . . . . . . . . .
 . . . . . . . . . . . . . . . . # . . . # . # . . . . . . . . . . . . . . . . . .
 . . . . . . . . . . . . . . . . # . . . # . # . . . . . . . . . . . . . . . . . .
 . . . . . . . . . . . . . . . . # . . . # . # . . . . . . . . . . . . . . . . . .
 . . . . . . . . . . # # # # # # # # # # # # # . . . . . . . . . . . . . . . . . .
 . . . . . . . . . . # . . . . . # . . . # . . . . . . . . . . . . . . . . . . . .
 . . . . . . . . . . # . . . . . # # # # # . . . . . . . . . . . . . . . . . . . .
 . . . . . . . . . . # . . . . . . . . . . . . . . . . . . . . . . . . . . . . . .
 . . . . . . . . . . # # # # # # # . . . . . . . . . . . . . . . . . . . . . . . .
 . . . . . . . . . . . . . . . . # . . . . . . . . . . . . . . . . . . . . . . . .
 . . . . . . . . . . . . . . . . # . # . . . . . . . . . . . . . . . . . . . . . .
 . . . . . . . . . . . . . . . . # . # . . . . . . . . . . . . . . . . . . . . . .
 . . . . . . . . . . . . . . . . # . # . . . . . . . . . . . . . . . . . . . . . .
 . . . . . . . . . . . . . . . . # . # . . . . . . . . . . . . . . . . . . . . . .
 . . . . . . . . . . . . . . . . # # # # # # # . . . . . . . . . . . . . . . . . .
 . . . . . . . . . . . . . . . . . . # . . . # . . . . . . . . . . . . . . . . . .
 . . . . . . . . . . . . . . . . . . # # # # # # # # # # # . . . . . . . . . . . .
 . . . . . . . . . . . . . . . . . . . . . . # . . . . . # . . . . . . . . . . . .
 . . . . . . . . . . . . . . . . . . . . . . # . . . . . # . . . . . . . . . . . .
 . . . . . . . . . . . . . . . . . . . . . . # . . . . . # . . . . . . . . . . . .
 . . . . . . . . . . . . . . . . . . . . . . # . . . . . # . . . . . . . . . . . .
 . . . . . . . . . . . . . . . . . . . . . . # . . . . . # . . . . . . . . . . . .
 . . . . . . . . . . . . . . . . . . . . . . # . . . . . # . . . . . . . . . . . .
 . . . . . . . . . . . . . . . . . . . . . . # . . . . . # . . . . . . . . . . . .
 . . . . . . . . . . . . . . . . . . . . . . # . . . . . # . . . . . . . . . . . .
 . . . . . . . . . . . . . . . . . . . . . . # . . . . . # . . . . . . . . . . . .
 . . . . . . . . . . . . . . . . . . . . . . # # # # # # # . . . . . . . . . . . .
